####################################                      
#                                  #
#                                  # 
#                                  #
#                                  #
#                                  #   
#                                  #	
#                                  #
#                                  #
#                                  #
#                                  #	
# P                                #
#                                  #
#                       D          #                                 
#                                  #
#                     1===2        #
####################################